######### ##########
#..................#
#..................#
#..................#
#..................#
#...........########
#...........#...H..#
#...........#......#
#...........#......#
#...........####...#
#..................#
#..................#
#..................#
#..................#
#...##.............#
#....#.............#
#.B..#.............#
####################
